[
    ["p", "_", "_", "_", "r", "r", "_", "_", "_", "p"],
    ["p", "p", "_", "_", "r", "r", "_", "_", "p", "p"],
    ["_", "p", "p", "_", "_", "_", "_", "p", "p", "_"],
    ["_", "_", "p", "p", "_", "_", "p", "p", "_", "_"],
    ["r", "r", "_", "p", "p", "p", "p", "_", "r", "r"],
    ["r", "r", "_", "_", "p", "p", "_", "_", "r", "r"],
    ["_", "_", "_", "p", "p", "p", "p", "_", "_", "_"],
    ["_", "_", "p", "p", "_", "_", "p", "p", "_", "_"],
    ["_", "p", "p", "_", "_", "_", "_", "p", "p", "_"],
    ["p", "p", "_", "_", "s", "s", "_", "_", "p", "p"],
    ["_", "p", "p", "_", "_", "_", "_", "p", "p", "_"],
    ["_", "_", "p", "p", "_", "_", "p", "p", "_", "_"],
    ["_", "_", "_", "p", "p", "p", "p", "_", "_", "_"],
    ["r", "r", "_", "_", "p", "p", "_", "_", "r", "r"],
    ["r", "r", "_", "_", "p", "p", "_", "_", "r", "r"],
    ["_", "_", "_", "p", "_", "_", "p", "_", "_", "_"],
    ["_", "_", "p", "p", "_", "_", "p", "p", "_", "_"],
    ["_", "p", "p", "_", "_", "_", "_", "p", "p", "_"],
    ["p", "p", "_", "_", "r", "r", "_", "_", "p", "p"],
    ["_", "p", "_", "_", "r", "r", "_", "_", "p", "_"]
]
