[
	["_", "_", "_", "_", "_", "_", "_", "_", "_", "_"],
	["_", "_", "_", "_", "_", "_", "_", "_", "_", "_"],
	["_", "_", "r", "r", "r", "r", "r", "r", "_", "_"],
	["_", "r", "r", "r", "r", "r", "r", "r", "r", "_"],
	["_", "r", "r", "r", "r", "r", "r", "r", "r", "_"],
	["_", "r", "r", "r", "r", "r", "r", "r", "r", "_"],
	["_", "_", "r", "r", "r", "r", "r", "r", "_", "_"],
	["_", "_", "_", "_", "_", "_", "_", "_", "_", "_"],
	["_", "_", "_", "_", "_", "_", "_", "_", "_", "_"],
	["_", "_", "_", "_", "_", "_", "_", "_", "_", "_"],
	["_", "_", "_", "_", "_", "_", "_", "_", "_", "_"],
	["_", "_", "_", "_", "_", "_", "_", "_", "_", "_"],
	["_", "_", "s", "_", "_", "_", "_", "p", "_", "_"],
	["_", "_", "_", "_", "_", "_", "_", "_", "_", "_"],
	["_", "_", "_", "_", "_", "_", "_", "_", "_", "_"],
	["_", "_", "_", "_", "_", "_", "_", "_", "_", "_"],
	["_", "_", "_", "_", "_", "_", "_", "_", "_", "_"],
	["_", "_", "_", "_", "_", "_", "_", "_", "_", "_"],
	["_", "_", "_", "_", "_", "_", "_", "_", "_", "_"],
	["_", "_", "_", "_", "_", "_", "_", "_", "_", "_"]
]
