[
	["r", "s", "p", "r", "s", "p", "r", "s", "p", "r"],
	["_", "_", "_", "_", "_", "_", "_", "_", "_", "s"],
	["_", "_", "_", "_", "_", "_", "_", "_", "s", "p"],
	["_", "_", "_", "_", "_", "_", "_", "s", "p", "r"],
	["_", "_", "_", "_", "_", "_", "s", "p", "r", "s"],
	["_", "_", "_", "_", "_", "s", "p", "r", "s", "p"],
	["_", "_", "_", "_", "s", "p", "r", "s", "p", "r"],
	["_", "_", "_", "s", "p", "r", "s", "p", "r", "s"],
	["_", "_", "s", "p", "r", "s", "p", "r", "s", "p"],
	["_", "s", "p", "r", "s", "p", "r", "s", "p", "r"],
	["_", "_", "_", "_", "_", "_", "_", "_", "_", "s"],
	["_", "_", "_", "_", "_", "_", "_", "_", "s", "p"],
	["_", "_", "_", "_", "_", "_", "_", "s", "p", "r"],
	["_", "_", "_", "_", "_", "_", "s", "p", "r", "s"],
	["_", "_", "_", "_", "_", "s", "p", "r", "s", "p"],
	["_", "_", "_", "_", "s", "p", "r", "s", "p", "r"],
	["_", "_", "_", "s", "p", "r", "s", "p", "r", "s"],
	["_", "_", "s", "p", "r", "s", "p", "r", "s", "p"],
	["_", "s", "p", "r", "s", "p", "r", "s", "p", "r"],
	["_", "_", "_", "_", "_", "_", "_", "_", "_", "s"]
]
