[
    ["_", "_", "_", "_", "_", "_", "_", "_", "_", "_"],
    ["_", "s", "s", "_", "_", "_", "_", "p", "p", "_"],
    ["_", "s", "s", "_", "_", "_", "_", "p", "p", "_"],
    ["_", "_", "_", "_", "_", "_", "_", "_", "_", "_"],
    ["_", "_", "_", "_", "_", "_", "_", "_", "_", "_"],
    ["_", "_", "_", "_", "r", "r", "_", "_", "_", "_"],
    ["_", "_", "_", "_", "r", "r", "_", "_", "_", "_"],
    ["_", "_", "_", "_", "_", "_", "_", "_", "_", "_"],
    ["_", "_", "_", "_", "r", "r", "_", "_", "_", "_"],
    ["_", "p", "p", "_", "r", "r", "_", "p", "p", "_"],
    ["_", "p", "p", "_", "_", "_", "_", "p", "p", "_"],
    ["_", "_", "_", "_", "r", "r", "_", "_", "_", "_"],
    ["_", "_", "_", "_", "r", "r", "_", "_", "_", "_"],
    ["_", "_", "_", "_", "_", "_", "_", "_", "_", "_"],
    ["_", "_", "_", "_", "r", "r", "_", "_", "_", "_"],
    ["_", "_", "_", "_", "r", "r", "_", "_", "_", "_"],
    ["_", "_", "_", "_", "_", "_", "_", "_", "_", "_"],
    ["_", "r", "r", "_", "_", "_", "_", "s", "s", "_"],
    ["_", "r", "r", "_", "_", "_", "_", "s", "s", "_"],
    ["_", "_", "_", "_", "_", "_", "_", "_", "_", "_"]
]