[
    ["_", "_", "_", "_", "s", "_", "_", "_", "_", "_"],
    ["_", "_", "_", "p", "r", "p", "_", "_", "_", "_"],
    ["_", "_", "s", "r", "_", "r", "s", "_", "_", "_"],
    ["_", "p", "r", "_", "_", "_", "r", "p", "_", "_"],
    ["_", "r", "_", "_", "_", "_", "_", "r", "s", "_"],
    ["s", "r", "_", "_", "_", "_", "_", "_", "r", "p"],
    ["_", "s", "r", "_", "_", "_", "r", "_", "_", "_"],
    ["_", "_", "p", "r", "_", "r", "p", "_", "_", "_"],
    ["_", "_", "_", "s", "r", "_", "s", "_", "_", "_"],
    ["_", "_", "_", "_", "p", "r", "p", "_", "_", "_"],
    ["_", "_", "_", "_", "_", "s", "_", "_", "_", "_"],
    ["_", "_", "_", "_", "p", "r", "p", "_", "_", "_"],
    ["_", "_", "_", "s", "r", "_", "s", "_", "_", "_"],
    ["_", "_", "p", "r", "_", "r", "p", "_", "_", "_"],
    ["_", "s", "r", "_", "_", "_", "r", "_", "_", "_"],
    ["_", "r", "_", "_", "_", "_", "_", "r", "s", "_"],
    ["s", "r", "_", "_", "_", "_", "_", "_", "r", "p"],
    ["_", "s", "r", "_", "_", "_", "r", "_", "_", "_"],
    ["_", "_", "p", "r", "_", "r", "p", "_", "_", "_"],
    ["_", "_", "_", "s", "r", "_", "s", "_", "_", "_"]

]