[
    ["s", "_", "_", "_", "_", "_", "_", "_", "_", "s"],
    ["s", "_", "_", "_", "_", "_", "_", "_", "_", "s"],
    ["s", "_", "_", "_", "_", "_", "_", "_", "_", "s"],
    ["s", "_", "_", "_", "_", "_", "_", "_", "_", "s"],
    ["s", "_", "_", "_", "_", "_", "_", "_", "_", "s"],
    ["s", "_", "_", "_", "_", "_", "_", "_", "_", "s"],
    ["s", "_", "_", "_", "_", "_", "_", "_", "_", "s"],
    ["s", "_", "r", "_", "_", "_", "_", "r", "_", "s"],
    ["s", "_", "_", "_", "_", "_", "_", "_", "_", "s"],
    ["s", "_", "_", "_", "p", "p", "_", "_", "_", "s"],
    ["s", "_", "_", "_", "p", "p", "_", "_", "_", "s"],
    ["s", "_", "_", "_", "_", "_", "_", "_", "_", "s"],
    ["s", "_", "r", "_", "_", "_", "_", "r", "_", "s"],
    ["s", "_", "_", "_", "_", "_", "_", "_", "_", "s"],
    ["s", "_", "_", "_", "_", "_", "_", "_", "_", "s"],
    ["s", "_", "_", "_", "_", "_", "_", "_", "_", "s"],
    ["s", "_", "_", "_", "_", "_", "_", "_", "_", "s"],
    ["s", "_", "_", "_", "_", "_", "_", "_", "_", "s"],
    ["s", "_", "_", "_", "_", "_", "_", "_", "_", "s"],
    ["s", "_", "_", "_", "_", "_", "_", "_", "_", "s"]
]