[
    ["p", "_", "_", "_", "r", "r", "_", "_", "_", "p"],
    ["_", "p", "_", "_", "_", "_", "_", "_", "p", "_"],
    ["_", "_", "p", "_", "_", "_", "_", "p", "_", "_"],
    ["_", "_", "_", "p", "_", "_", "p", "_", "_", "_"],
    ["_", "r", "_", "_", "p", "p", "_", "_", "r", "_"],
    ["_", "r", "_", "_", "p", "p", "_", "_", "r", "_"],
    ["_", "_", "_", "p", "_", "_", "p", "_", "_", "_"],
    ["_", "_", "p", "_", "_", "_", "_", "p", "_", "_"],
    ["_", "p", "_", "_", "s", "s", "_", "_", "p", "_"],
    ["p", "_", "_", "_", "_", "_", "_", "_", "_", "p"],
    ["_", "p", "_", "_", "s", "s", "_", "_", "p", "_"],
    ["_", "_", "p", "_", "_", "_", "_", "p", "_", "_"],
    ["_", "_", "_", "p", "_", "_", "p", "_", "_", "_"],
    ["_", "r", "_", "_", "p", "p", "_", "_", "r", "_"],
    ["_", "r", "_", "_", "p", "p", "_", "_", "r", "_"],
    ["_", "_", "_", "p", "_", "_", "p", "_", "_", "_"],
    ["_", "_", "p", "_", "_", "_", "_", "p", "_", "_"],
    ["_", "p", "_", "_", "_", "_", "_", "_", "p", "_"],
    ["p", "_", "_", "_", "_", "_", "_", "_", "_", "p"],
    ["_", "p", "_", "_", "r", "r", "_", "_", "p", "_"]
]
