[
    ["_", "_", "_", "_", "_", "s", "_", "_", "_", "_"],
    ["_", "_", "_", "_", "p", "r", "p", "_", "_", "_"],
    ["_", "_", "_", "s", "r", "r", "r", "s", "_", "_"],
    ["_", "_", "p", "r", "r", "r", "r", "r", "p", "_"],
    ["_", "s", "r", "r", "r", "r", "r", "r", "r", "s"],
    ["_", "p", "r", "r", "r", "r", "r", "r", "p", "s"],
    ["_", "_", "s", "r", "r", "r", "r", "s", "_", "_"],
    ["_", "_", "_", "p", "r", "r", "r", "p", "_", "_"],
    ["_", "_", "_", "_", "s", "r", "s", "_", "_", "_"],
    ["_", "_", "_", "_", "_", "p", "_", "_", "_", "_"],
    ["_", "_", "_", "_", "s", "r", "s", "_", "_", "_"],
    ["_", "_", "_", "p", "r", "r", "r", "p", "_", "_"],
    ["_", "_", "s", "r", "r", "r", "r", "s", "_", "_"],
    ["_", "p", "r", "r", "r", "r", "r", "r", "p", "s"],
    ["_", "s", "r", "r", "r", "r", "r", "r", "r", "s"],
    ["_", "_", "p", "r", "r", "r", "r", "r", "p", "_"],
    ["_", "_", "_", "s", "r", "r", "r", "s", "_", "_"],
    ["_", "_", "_", "_", "p", "r", "p", "_", "_", "_"],
    ["_", "_", "_", "_", "_", "s", "_", "_", "_", "_"],
    ["_", "_", "_", "_", "_", "_", "_", "_", "_", "_"]
]