[
	["_", "_", "_", "_", "_", "_", "_", "_", "_", "_"],
	["_", "_", "_", "_", "_", "_", "_", "_", "_", "_"],
	["_", "_", "_", "_", "_", "_", "_", "_", "_", "_"],
	["_", "_", "_", "_", "s", "_", "_", "_", "_", "_"],
	["_", "_", "_", "s", "r", "s", "_", "_", "_", "_"],
	["_", "_", "s", "r", "r", "r", "s", "_", "_", "_"],
	["_", "s", "r", "r", "r", "r", "r", "s", "_", "_"],
	["_", "r", "r", "r", "r", "r", "r", "r", "s", "_"],
	["_", "r", "r", "r", "p", "r", "r", "r", "_", "_"],
	["_", "r", "r", "r", "r", "r", "r", "r", "s", "_"],
	["_", "s", "r", "r", "r", "r", "r", "s", "_", "_"],
	["_", "_", "s", "r", "r", "r", "s", "_", "_", "_"],
	["_", "_", "_", "s", "r", "s", "_", "_", "_", "_"],
	["_", "_", "_", "_", "s", "_", "_", "_", "_", "_"],
	["_", "_", "_", "_", "_", "_", "_", "_", "_", "_"],
	["_", "_", "_", "_", "_", "_", "_", "_", "_", "_"],
	["_", "_", "_", "_", "_", "_", "_", "_", "_", "_"],
	["_", "_", "_", "_", "_", "_", "_", "_", "_", "_"],
	["_", "_", "_", "_", "_", "_", "_", "_", "_", "_"],
	["_", "_", "_", "_", "_", "_", "_", "_", "_", "_"]
]
