[ 
	[ "_", "_", "_", "_", "s", "s", "_", "_", "_", "_" ],
	[ "_", "_", "r", "_", "_", "_", "_", "r", "_", "_" ],
	[ "s", "_", "_", "_", "s", "s", "_", "_", "_", "s" ],
	[ "_", "r", "_", "p", "_", "_", "p", "_", "r", "_" ],
	[ "r", "r", "p", "_", "_", "_", "_", "p", "r", "r" ],
	[ "s", "_", "_", "_", "_", "_", "_", "_", "_", "s" ],
	[ "s", "_", "_", "_", "_", "_", "_", "_", "_", "s" ],
	[ "_", "_", "_", "r", "_", "_", "r", "_", "_", "_" ],
	[ "s", "_", "_", "p", "_", "_", "p", "_", "_", "s" ],
	[ "r", "s", "r", "s", "_", "_", "s", "r", "s", "r" ],
	[ "_", "_", "s", "r", "_", "_", "r", "s", "_", "_" ],
	[ "_", "r", "s", "_", "p", "p", "_", "s", "r", "_" ],
	[ "s", "_", "p", "_", "s", "s", "_", "p", "_", "s" ],
	[ "_", "r", "_", "_", "_", "_", "_", "_", "r", "_" ],
	[ "_", "_", "s", "r", "_", "_", "r", "s", "_", "_" ],
	[ "p", "_", "p", "_", "s", "s", "_", "p", "_", "p" ],
	[ "_", "_", "_", "_", "_", "_", "_", "_", "_", "_" ],
	[ "_", "_", "_", "_", "_", "_", "_", "_", "_", "_" ],
	[ "_", "s", "r", "_", "_", "_", "_", "r", "s", "_" ],
	[ "_", "s", "s", "_", "_", "_", "_", "s", "s", "_" ] 
]
