[
    ["_", "_", "_", "_", "r", "_", "_", "p", "_", "_"],
    ["_", "_", "_", "r", "_", "p", "_", "_", "_", "p"],
    ["_", "p", "_", "_", "_", "_", "_", "_", "r", "s"],
    ["_", "_", "_", "_", "p", "r", "_", "_", "s", "r"],
    ["_", "_", "r", "_", "_", "p", "_", "s", "_", "s"],
    ["_", "_", "r", "_", "s", "_", "p", "_", "_", "r"],
    ["_", "p", "_", "_", "_", "_", "_", "_", "_", "p"],
    ["_", "_", "_", "_", "_", "r", "_", "_", "_", "r"],
    ["_", "p", "_", "_", "s", "r", "_", "_", "r", "s"],
    ["_", "_", "_", "_", "_", "_", "_", "_", "_", "s"],
    ["r", "_", "p", "_", "_", "_", "s", "r", "_", "r"],
    ["p", "_", "s", "_", "_", "_", "_", "_", "r", "p"],
    ["_", "_", "_", "_", "_", "_", "_", "_", "_", "s"],
    ["r", "p", "_", "_", "s", "_", "r", "_", "_", "p"],
    ["_", "r", "_", "_", "_", "_", "_", "p", "_", "r"],
    ["_", "_", "_", "p", "_", "_", "_", "_", "s", "r"],
    ["_", "_", "_", "r", "_", "_", "_", "p", "_", "r"],
    ["_", "_", "_", "_", "p", "_", "_", "r", "_", "s"],
    ["_", "p", "_", "_", "_", "_", "_", "_", "_", "p"],
    ["_", "_", "_", "_", "_", "_", "_", "_", "_", "s"]
]